...####################################################################################################################################################
......#........#.....#..............#...........#.....#...........#........#.....#...........#..#...........#........#........#.....#........#..#..#..#
#..#..#######..#..#..#..#######..#..#..#..#..####..#..#..####..#######..#######..#######..####..#######..####..####..#..####..#..#######..#..#..#..#..#
#..#...........#..#..#.....#.....#.....#..#..#.....#..#.....#.....#........#.....#..#.......................#..#........#........#..#.....#..#........#
#..#############..####..#..#..####..#..#..####..#..####..####..#..#######..#..####..#..####..#######..####..#######..####..#..#..#..#..#######..#..#..#
#........#..............#..#.....#..#..#........#..#..#.....#..#.....#..#..#.....#........#.....#..#..#.....#...........#..#..#.....#..#.....#..#..#..#
#..################..######################..#######..####..####..#..#..#..####..#..##########..#..#..#..#..####..#..####..#######..#..#..####..#######
#...........#..............#..#.....#.....#..#..#..............#..#..#...........#..#..#.....#..#.....#..#.....#..#..#..#..#.....#.....#.....#........#
#..####..#..#..#############..####..#..####..#..#..#######..################..#..#..#..####..####..#..#######..####..#..#..#..#..#..####..#..####..#..#
#.....#..#.....#........#........#.....#...........#..#..#.....#..#..#........#..#........#.....#..#..#..#..#..#.....#.....#..#...........#..#..#..#..#
##########..####..##########..#######..#######..####..#..#######..#..#..###################..#..#..####..#..####..##########..#..####..#######..#..####
#..#..#.......................#..#..#..#..............#..#.....#..#...........#.....#........#.....#.....#.................#..#..#..#........#.....#..#
#..#..#..######################..#..#..####..####..####..#..####..#..#######..####..####..#..##########..####..#..#######..####..#..#######..####..#..#
#.....#...........#..#...........#.....#..#..#.....#........#.....#.....#.....#........#..#.....#..#...........#.....#..#.....#.....#.................#
#..####..#..#..####..#..#######..#..####..#######..#..####..#..#############..####..#..####..#..#..#..##########..####..#######..#..#..####..####..####
#........#..#..#.....#........#...........#..#..#.....#.............................#..#..#..#..#.....#..#..#.....#........#.....#..#..#........#.....#
#..#..####..#..#..##########..#######..#..#..#..##########..####..#..#######..##########..####..####..#..#..####..#######..#######..##########..####..#
#..#..#.....#...........#..#.....#.....#..#.................#.....#........#.....#.....#..#..#.....#..#..#...........#..#........#..#..#...........#..#
#######..#..#..##########..#..##########..####..####..#..#######..#######..####..####..#..#..####..#..#..#############..####..#######..#..#######..#..#
#..#.....#..#....................#........#.....#..#..#..#........#........#.....#..#.....#..#..#........#.....#........#........#........#........#..#
#..####..#######..#..##########..#..#..#..####..#..####..#..##########..#######..#..####..#..#..#..#..####..#..#..##########..################..#######
#........#..#.....#.....#.....#..#..#..#..#..#........#..#..#.....#..#........#...........#........#........#...........#........#.....#.....#..#.....#
##########..#######..#######..#############..#..#############..#..#..############################..#############..#..#..#..####..#..####..#..#..#..####
#.................#........#..#........#..#..............#..#..#.....#.................#........#.....#.....#.....#..#..#.....#...........#..#.....#..#
#..#######..#..#..#######..#..#######..#..#..####..####..#..#..####..##########..####..#######..####..#..##########..#######..###################..#..#
#........#..#..#...........#...........#.....#.....#.....#.....#...........#.....#..#..#..#........#..#..#.................#..#...........#...........#
#..###################..#######..################..####..#..#############..#######..#..#..#..####..#..#..####..#######..####..#######..####..#..#..#..#
#..#...........#..#.....#.....#...........#.....#..#........#..#.....#.....#.....#........#.....#..#..#........#........#........#..#........#..#..#..#
##########..####..#..#..####..#..#..####..####..#######..####..#..#..##########..####..#..#..#..#..#..####..#..####..#######..####..####..#..#######..#
#.....#..#.....#..#..#..#........#..#..#.....#.....#.....#..#..#..#..#..#.....#..#..#..#..#..#..#..#..#.....#..#........#..#.....#..#.....#........#..#
####..#..####..#..#..#..#..#######..#..#..####..#..#..####..#..####..#..####..#..#..####..####..#..#..#######..#######..#..#..####..##########..#..####
#.....#...........#..#........#.....#...........#..#....................#........#.....#........#.....#.....#........#...........#..#........#..#..#..#
####..#..####..#..#######..#..#######..####..#..#..##########..#..#######..####..####..#..#######..#..#..##########..#######..####..####..#..#######..#
#........#.....#..#..#..#..#..#..#........#..#..#..#..#........#...........#...........#........#..#..#...........#..#.....#..#...........#...........#
#..#..#..#..#######..#..#######..#..#######..#..####..#######..#..####..#..#..#######..#######..################..####..#..#..####..#..#######..####..#
#..#..#..#...........#..#.....#..#........#..#..#..#.....#.....#.....#..#..#..#..#...........#........#.....#........#..#..#..#.....#..#..#........#..#
##########..#..#######..####..#..####..####..####..####..####..#######..#######..####..#############..#..####..##########..#..####..####..####..#..####
#........#..#.....#.....#..#.....#..#..#..#...........#.....#..#........#.......................#.....#..#..#........#........#.....#........#..#..#..#
#..####..#..#######..####..####..#..####..#..#######..#..####..################..#############..####..#..#..#######..####..####..#######..#..####..#..#
#..#..#..#........#........#.....#..#..............#..#.....#..#..#..#.....#..#..#........#.....#.....#.....#..#...........#.....#..#.....#.....#.....#
#..#..##########..#..#..#######..#..#######..##########..####..#..#..####..#..#..####..####..#############..#..#..#######..#######..####..#..#..####..#
#.................#..#..#..#..#..............#...........#.....#.....#..#..#..#..#..#.....#..#........#...........#..#.................#..#..#........#
#######..#..####..#..####..#..#..####..####..#######..#..#..#..####..#..#..#..#..#..#..####..####..#######..#..####..#######..#######..#######..#..####
#..#.....#..#..#.....#...........#........#..#........#..#..#........#..#..#..#..#..#..#..#..#.....#........#..#.....#..#..#..#........#.....#..#.....#
#..#..#..#..#..####..#..#..####..####..####..#..#######..##########..#..#..#..####..#..#..#..####..#..#..#..#..####..#..#..##########..#..#..#######..#
#.....#..#..#........#..#.....#..#..#..#........#.....#........#.....#.................#..#.....#..#..#..#..#..#........#..#...........#..#..#........#
#######..##########..#..#..#..#..#..#..#..#..#######..#..#..#############..####..#..#..#..#..####..#..####..#######..#..#..#..#######..#..####..#######
#...........#..#........#..#..#..#..#..#..#..#..#.....#..#..#..#..............#..#..#.....#........#..#........#.....#..#..#..#..#..#.................#
#..##########..#..####..#######..#..####..####..#..#######..#..#..#..#######..#######..################..#######..#######..#..#..#..#############..####
#.....#...........#.....#.....#..#..#.....#..#........#...........#.....#........#........#..#...........#..#....................#..............#..#..#
#..#..####..#############..#..#..#..####..#..#..####..#############..################..####..####..####..#..#..####..#######..#..##########..####..#..#
#..#..#..#..#..#..#..#..#..#.....#...........#..#........#.....#..#..#.....#.....#.....#.....#..#..#.....#..#.....#.....#..#..#.....#.....#.....#..#..#
#######..#..#..#..#..#..#..#..####..#..####..#..##########..####..#..#..#..#..##########..####..##########..##########..#..#..#..####..#######..####..#
#...........#.....#..#.....#..#..#..#.....#.....#........#...........#..#...........#..#........#..#..#........#..#.....#..#..#.......................#
#..#..#..#######..#..####..####..####..##########..#######..################..####..#..####..####..#..#######..#..####..#..#..####..#..#..#..#######..#
#..#..#........#...........#........#..#........#..#.....#.....#..............#..#.....#.....#..............#.....#..#..#........#..#..#..#..#........#
#..#######..#..####..#..#..#..#######..#..#..#..#..#..####..####..#..#######..#..####..#..#..#######..#..####..####..#########################..#######
#.....#.....#..#.....#..#........#.....#..#..#..#...........#..#..#.....#...........#..#..#..#........#.....#.....#...........#..#..............#.....#
#..#######..####..#..#######..#..#######..####..#..####..####..#######..###################..#..#######..####..#..####..#..####..#######..##########..#
#........#.....#..#.....#..#..#..#.....#..#........#..#.......................#........#..#.....#.....#.....#..#.....#..#..#........#...........#.....#
####..################..#..#######..##########..#..#..#..#######..##########..#######..#..#..#..#..####..#######..#######..#######..####..#..#######..#
#.....#........#..#..#.....#...........#........#.....#..#.................#..#...........#..#........#.....#..#..........................#..#..#..#..#
#..#..#..####..#..#..####..#..####..#..####..#..#..####..#######..##########..#######..#..#..#..#..#..#######..#..#..#..#..####..#############..#..#..#
#..#.....#........#..#.....#..#.....#.....#..#..#..#...........#.....#..#..#..#.....#..#..#..#..#..#........#.....#..#..#..#........#..#..#..#.....#..#
#..#############..#..####..####..####..#..####..#######..####..#..#..#..#..####..#######..#..#..##########..#..####..################..#..#..#..####..#
#...........#.....#..#..#..#..#.....#..#.....#.....#........#..#..#....................#..#..#..#..............#........#...........#...........#.....#
##########..####..#..#..####..####..#..####..###################..#######..#######..#..#..#############..##########..#..#..#..##########..####..####..#
#..............#..#........#........#..#.....#.....#........#...........#..#..#..#..#..#.....#.....#..#........#.....#.....#.................#.....#..#
#############..#..#######..#############..####..##########..#..#############..#..#..#######..####..#..#######..#..####..####..#..##########..#######..#
#.....#..#.....#..#........#........#.....#...........#..#........#..#........#.....#...........#.....#........#..#.....#..#..#..#.....#.....#..#.....#
#..####..#..#..####..#..####..####..####..####..#######..####..#..#..#..#..#######..#######..####..####..#..#..#######..#..####..#..#######..#..#..####
#...........#..#.....#........#.....#.....#.....#..#........#..#..#..#..#.....#..#..#........#..#.....#..#..#..#..#.....#..#...........#..#...........#
#..####..#######..##########..####..####..#..####..#..#..####..####..#..#..####..#..#..####..#..#..#..####..####..#######..####..#..####..#..#..#..####
#..#.....#..#..#...........#.....#..#.....#...........#..#..#.....#.....#..#........#.....#.....#..#...........#.....#..#........#.....#..#..#..#.....#
#..#..#..#..#..################..#..####..#..####..#..####..#######..#..##########..####..###################..####..#..################..#..#######..#
#..#..#.......................#..#.....#.....#.....#...........#..#..#.....#...........#........#........#........#...........#..#........#..#........#
#..#..#..##########..#..##########..#..#..#..#..#######..#######..#######..#..#..#..#..####..#######..#..####..####..#######..#..####..#..#..#######..#
#..#..#..#.....#..#..#..#........#..#..#..#..#..#..#..#........#........#.....#..#..#...........#.....#...........#........#...........#..#.....#.....#
#..####..#..#..#..####..#..#..#..####..#..#######..#..#######..#######..################..#..#######..#######..#######..##########..#..#######..#######
#..#..#..#..#.....#.....#..#..#...........#........#.....#..#..#..#...........#........#..#..#..#.....#..#........#...........#.....#..#..#........#..#
#..#..#..####..####..################..####..#..#######..#..####..#######..#######..####..####..#..#..#..#######..################..####..##########..#
#.....#..#........#........#..............#..#.....#........#..#.............................#.....#..#.....#.....#.......................#.....#.....#
#############..####..#..#..#..####..#..#..#..##########..####..####..####..####..####..#######..#######..####..#..####..#############..####..#######..#
#........#........#..#..#..#..#.....#..#.....#..............#...........#.....#..#........#.....#..#..#.....#..#.....#........#..#.....#.....#..#.....#
#######..####..#..#..#######..####..#######..#..#######..#..#######..#######..##########..#..####..#..#..####..#############..#..####..#..####..#..#..#
#........#.....#..#..#...........#........#..#........#..#..#.....#..#.....#..#..#.....#...........#.............................#..#.....#..#.....#..#
#..####..#..#######..#..##########..##########..#######..#######..####..#######..####..#..################..####..#############..#..#######..#..#######
#.....#.....#........#.....#.................#..#.....#..#.....#.....#.....#..#....................#...........#..#.....#........#..#.....#........#..#
#..####..#######..#..#..#..####..#######..####..#..####..#..####..#..#..#..#..####..##########..##########..#..####..#..##########..#..#..#..#..####..#
#.....#..#..#.....#.....#..#........#...........#..#...........#..#.....#....................#........#.....#..#.....#..#..#.....#..#..#..#..#.....#..#
#######..#..#..####..#..#######..#######..#..#..#..#..################..####..#..#######..##########..#######..#..#..####..####..#..#..#######..#..#..#
#..............#.....#..#..#.....#.....#..#..#..#..............#........#..#..#........#..#........#..#...........#..#.....#....................#.....#
####..#############..#..#..####..#..#..##########..###################..#..#######..#############..#..#..####..#..####..####..#######..#######..#######
#..............#..#..#.....#..#.....#.....#..#........#.....#.....#.....#........#..#........#.....#..#.....#..#.....#........#.....#..#..............#
#..##########..#..#..#######..#######..#..#..####..#######..####..####..#..####..####..#..####..####..#..####..#..#..#######..#..##########..####..####
#..#..#..#..#.....#........#.....#.....#..#.....#..#....................#.....#........#..#...........#..#..#..#..#....................#..#.....#.....#
#..#..#..#..####..#..####..#..#..####..####..#..#..####..####..####..#..#############..####..#..#######..#..#..####..#..####..#######..#..####..#######
#.....#..#........#.....#.....#..#.....#..#..#.....#.....#........#..#...........#........#..#........#.....#..#.....#.....#........#.....#.....#.....#
#..####..#..####..#######..####..#..####..####..#..#..#..####..##########..#..#..####..#..#######..####..#######..#..#..#######..#..#..#######..#..#..#
#........#.....#.....#.....#.....#..#...........#..#..#..#.....#...........#..#........#..#........#........#.....#..#........#..#..#........#.....#..#
####################################################################################################################################################...
